111111111111111
100000100000001
1000C00000C0001
1P000000C000001
1000100000010E1
111111111111111