111111
1C1C01
1010C1
1P0001
1010E1
111111
