111111111
1C1C00011
1010C0001
1P0000011
101001001
111111111
