111111111111111
1000001000001C1
1000C00000C0011
1P000000C000001
1000100000010E1
111111111111111
