111111111
1C1C00001
10100C001
1P0000011
1001010E1
111111111